br.xpm br.xpm br.xpm br.xpm
1111111111111
1000000100001
1000000100001
1000000100011
1000000000001
1000000000001
1000000000001
1000000000001
1000000000001
1000000000001
1000000000001
1000000000001
1111111111111
