br1.xpm br2.xpm br1.xpm br2.xpm
1111111111111
1000000000001
1000000000001
1001011100001
1001000110001
1001110100001
1000010100001
1000010111101
1000010000101
1000011110101
1000000010101
1000000010101
1111111111111
